NO ./data/wall_floor_ceiling/wall_basic.xpm
SO ./data/wall_floor_ceiling/wall_bricked_door.xpm

WE ./data/wall_floor_ceiling/wall_mossy_bricked_door.xpm




EA ./data/wall_floor_ceiling/wall_window.xpm

F 54,46,43
C 115,133,133






        1111111111111111111111111
        1000000000000000000000001
        10110000000000000000W0001
        1001000000000000000000001
111111111011000001110000000000001
100000000011000001110111111111111
11110111101111011100000010001
   101   0   101 100000010001
 111011110111101 101010010001
11000000110101011100000000001
10000000000000001100000010001
10000000000000001111010010001
11000001110101011100011110001
 1110111 1110101 101111000001
   111     11111 111 11111111