NO ./data/wall_floor_ceiling/wall_basic.xpm
SO ./data/wall_floor_ceiling/wall_bricked_door.xpm

WE ./data/wall_floor_ceiling/wall_mossy_bricked_door.xpm




EA ./data/wall_floor_ceiling/wall_window.xpm

F 54,46,43
C 115,133,133






        1111111111111111111111111
        1000E00000000000000000001
        1011000000000000000000001
        1001000000000000000000001
111111111011000001110000000000001
100000000011000001110111111111111
11110111111111011100000010001
11110111111111011101010010001
11000000110101011100000010001
10000000000000001100000010001
10000000000000001101010010001
1100000111010101111101111000111
11110111 1110101 101111010001
11111111 1111111 111111111111