11151111111
100S00100b1
100000A0003
50020040001
100a0011B11
1000001101
1115111161