  141   1114135311114111
  1S1211100000x000000005
  100000001a120211120211
11131A11111111B10D01C1
5000000x00040201026101
111b1y1011110001012101
  11101130000114000001
  11101110214101311101
  50000d400000x000c451
  111011110151131201
    101  105 5000101
    101  10151020101
    151  10000040001
         11111111111