11111111111161
1a01110001b1B1
110100y1000101
11010101111101
1E0A0100000001
11111111111111