  111   1111111111111111
  1S1111100000x000000001
  100000001a110111110111
11111A11111111B10D01C1
1000000x00010101016101
111b1y1011110001011101
  11101110000111000001
  11101110111101111101
  10000d100000x000c111
  111011110111111101
    101  101 1000101
    101  10111010101
    111  10000010001
         11111111111