1121111111
1000000003
5000000001
10000N0006
1111111141