13111131115161
5a02310001b1B1
110100y2000101
11010101111201
4E0A0100000005
11215131111141